11111111
12222221
13333331
10000001
11111111