 22222222
 33222233
 44222244
 55222255
 22222222