11111111
13333331
14444441
15555551
12222221