22222222
33333333
44444444
55555555
22222222